Afghanistan - Afghanistan
Albania - Albania
Algérie - Algeria
Andorra - Andorra
Angola - Angola
Antigua và Barbuda - Antigua and Barbuda
Argentina - Argentina
Armenia - Armenia
Úc - Australia
Áo - Austria
Azerbaijan - Azerbaijan
Bahamas - Bahamas
Bahrain - Bahrain
Bangladesh - Bangladesh
Barbados - Barbados
Belarus - Belarus
Bỉ - Belgium
Belize - Belize
Bénin - Benin
Bhutan - Bhutan
Bolivia - Bolivia
Bosna và Hercegovina - Bosnia and Herzegovina
Botswana - Botswana
Brasil - Brazil
Brunei - Brunei
Bulgaria - Bulgaria
Burkina Faso - Burkina Faso
Burundi - Burundi
Campuchia - Cambodia
Cameroon - Cameroon
Canada - Canada
Cabo Verde - Cape Verde
Cộng hòa Trung Phi - Central African Republic
Tchad - Chad
Chile - Chile
Trung Quốc - China
Colombia - Colombia
Comoros - Comoros
Costa Rica - Costa Rica
Bờ Biển Ngà - Côte d’Ivoire
Croatia - Croatia
Cuba - Cuba
Síp - Cyprus
Cộng hòa Séc - Czech Republic
Cộng hòa Dân chủ Congo - Democratic Republic of the Congo
Đan Mạch - Denmark
Djibouti - Djibouti
Dominica - Dominica
Cộng hòa Dominica - Dominican Republic
Đông Timor - East Timor
Ecuador - Ecuador
Ai Cập - Egypt
El Salvador - El Salvador
Guinea Xích Đạo - Equatorial Guinea
Eritrea - Eritrea
Estonia - Estonia
Ethiopia - Ethiopia
Fiji - Fiji
Phần Lan - Finland
Pháp - France
Gabon - Gabon
Gambia - Gambia
Gruzia - Georgia
Đức - Germany
Ghana - Ghana
Hy Lạp - Greece
Grenada - Grenada
Guatemala - Guatemala
Guinée - Guinea
Guiné-Bissau - Guinea-Bissau
Guyana - Guyana
Haiti - Haiti
Honduras - Honduras
Hungary - Hungary
Iceland - Iceland
Ấn Độ - India
Indonesia - Indonesia
Iran - Iran
Iraq - Iraq
Ai-len - Ireland
Israel - Israel
Ý - Italy
Jamaica - Jamaica
Nhật Bản - Japan
Jordan - Jordan
Kazakhstan - Kazakhstan
Kenya - Kenya
Kiribati - Kiribati
Kuwait - Kuwait
Kyrgyzstan - Kyrgyzstan
Lào - Laos
Latvia - Latvia
Liban - Lebanon
Lesotho - Lesotho
Liberia - Liberia
Libya - Libya
Liechtenstein - Liechtenstein
Litva - Lithuania
Luxembourg - Luxembourg
Madagascar - Madagascar
Malawi - Malawi
Malaysia - Malaysia
Maldives - Maldives
Mali - Mali
Malta - Malta
Quần đảo Marshall - Marshall Islands
Mauritanie - Mauritania
Mauritius - Mauritius
México - Mexico
Micronesia - Micronesia
Moldova - Moldova
Monaco - Monaco
Mông Cổ - Mongolia
Montenegro - Montenegro
Maroc - Morocco
Mozambique - Mozambique
Myanmar - Myanmar
Namibia - Namibia
Nauru - Nauru
Nepal - Nepal
Hà Lan - Netherlands
New Zealand - New Zealand
Nicaragua - Nicaragua
Niger - Niger
Nigeria - Nigeria
Bắc Triều Tiên - North Korea
Na Uy - Norway
Oman - Oman
Pakistan - Pakistan
Palau - Palau
Panama - Panama
Papua New Guinea - Papua New Guinea
Paraguay - Paraguay
Peru - Peru
Philippines - Philippines
Ba Lan - Poland
Bồ Đào Nha - Portugal
Qatar - Qatar
Cộng hòa Congo - Republic of the Congo
Cộng hòa Macedonia - Republic of Macedonia
Romania - Romania
Nga - Russia
Rwanda - Rwanda
Saint Kitts và Nevis - Saint Kitts and Nevis
Saint Lucia - Saint Lucia
Saint Vincent và Grenadines - Saint Vincent and the Grenadines
Samoa - Samoa
San Marino - San Marino
São Tomé và Príncipe - Sao Tome and Principe
Ả Rập Saudi - Saudi Arabia
Sénégal - Senegal
Serbia - Serbia
Seychelles - Seychelles
Sierra Leone - Sierra Leone
Singapore - Singapore
Slovakia - Slovakia
Slovenia - Slovenia
Quần đảo Solomon - Solomon Islands
Somalia - Somalia
Nam Phi - South Africa
Hàn Quốc - South Korea
Nam Sudan - South Sudan
Tây Ban Nha - Spain
Sri Lanka - Sri Lanka
Sudan - Sudan
Suriname - Suriname
Swaziland - Swaziland
Thụy Điển - Sweden
Thụy Sĩ - Switzerland
Syria - Syria
Tajikistan - Tajikistan
Tanzania - Tanzania
Thái Lan - Thailand
Togo - Togo
Tonga - Tonga
Trinidad và Tobago - Trinidad and Tobago
Tunisia - Tunisia
Thổ Nhĩ Kỳ - Turkey
Turkmenistan - Turkmenistan
Tuvalu - Tuvalu
Uganda - Uganda
Ukraina - Ukraine
Ả Rập Thống nhất - United Arab Emirates
Vương quốc Liên hiệp Anh và Bắc Ireland - United Kingdom
Chủng Quốc Hoa Kỳ - United States of America
Uruguay - Uruguay
Uzbekistan - Uzbekistan
Vanuatu - Vanuatu
Venezuela - Venezuela
Việt Nam - Vietnam
Yemen - Yemen
Zambia - Zambia
Zimbabwe - Zimbabwe
