Afghanistan - Afghanistan
Albania - Albanie
Algérie - Algérie
Andorra - Andorre
Angola - Angola
Antigua và Barbuda - Antigua-et-Barbuda
Argentina - Argentine
Armenia - Arménie
Úc - Australie
Áo - Autriche
Azerbaijan - Azerbaïdjan
Bahamas - Bahamas
Bahrain - Bahreïn
Bangladesh - Bangladesh
Barbados - Barbade
Belarus - Biélorussie
Bỉ - Belgique
Belize - Belize
Bénin - Bénin
Bhutan - Bhoutan
Bolivia - Bolivie
Bosna và Hercegovina - Bosnie-Herzégovine
Botswana - Botswana
Brasil - Brésil
Brunei - Brunei
Bulgaria - Bulgarie
Burkina Faso - Burkina Faso
Burundi - Burundi
Campuchia - Cambodge
Cameroon - Cameroun
Canada - Canada
Cabo Verde - Cap-Vert
Cộng hòa Trung Phi - République centrafricaine
Tchad - Tchad
Chile - Chili
Trung Quốc - Chine
Colombia - Colombie
Comoros - Comores
Costa Rica - Costa Rica
Bờ Biển Ngà - Côte d’Ivoire
Croatia - Croatie
Cuba - Cuba
Síp - Chypre
Cộng hòa Séc - République tchèque
Cộng hòa Dân chủ Congo - République démocratique du Congo
Đan Mạch - Danemark
Djibouti - Djibouti
Dominica - Dominique
Cộng hòa Dominica - République dominicaine
Đông Timor - Timor oriental
Ecuador - Équateur
Ai Cập - Égypte
El Salvador - Salvador
Guinea Xích Đạo - Guinée équatoriale
Eritrea - Érythrée
Estonia - Estonie
Ethiopia - Éthiopie
Fiji - Fidji
Phần Lan - Finlande
Pháp - France
Gabon - Gabon
Gambia - Gambie
Gruzia - Géorgie
Đức - Allemagne
Ghana - Ghana
Hy Lạp - Grèce
Grenada - Grenade
Guatemala - Guatemala
Guinée - Guinée
Guiné-Bissau - Guinée-Bissau
Guyana - Guyane
Haiti - Haïti
Honduras - Honduras
Hungary - Hongrie
Iceland - Islande
Ấn Độ - Inde
Indonesia - Indonésie
Iran - Iran
Iraq - Irak
Ai-len - Irlande
Israel - Israël
Ý - Italie
Jamaica - Jamaïque
Nhật Bản - Japon
Jordan - Jordan
Kazakhstan - Kazakhstan
Kenya - Kenya
Kiribati - Kiribati
Kuwait - Koweït
Kyrgyzstan - Kirghizistan
Lào - Laos
Latvia - Lettonie
Liban - Liban
Lesotho - Lesotho
Liberia - Liberia
Libya - Libye
Liechtenstein - Liechtenstein
Litva - Lituanie
Luxembourg - Luxembourg
Madagascar - Madagascar
Malawi - Malawi
Malaysia - Malaisie
Maldives - Maldives
Mali - Mali
Malta - Malte
Quần đảo Marshall - Îles Marshall
Mauritanie - Mauritanie
Mauritius - Maurice
México - Mexique
Micronesia - Micronésie
Moldova - Moldavie
Monaco - Monaco
Mông Cổ - Mongolie
Montenegro - Monténégro
Maroc - Maroc
Mozambique - Mozambique
Myanmar - Birmanie
Namibia - Namibie
Nauru - Nauru
Nepal - Népal
Hà Lan - Pays-Bas
New Zealand - Nouvelle-Zélande
Nicaragua - Nicaragua
Niger - Niger
Nigeria - Nigeria
Bắc Triều Tiên - Corée du Nord
Na Uy - Norvège
Oman - Oman
Pakistan - Pakistan
Palau - Palau
Panama - Panama
Papua New Guinea - Papouasie-Nouvelle-Guinée
Paraguay - Paraguay
Peru - Pérou
Philippines - Philippines
Ba Lan - Pologne
Bồ Đào Nha - Portugal
Qatar - Qatar
Cộng hòa Congo - République du Congo
Cộng hòa Macedonia - Macédoine
Romania - Roumanie
Nga - Russie
Rwanda - Rwanda
Saint Kitts và Nevis - Saint-Christophe-et-Niévès
Saint Lucia - Sainte-Lucie
Saint Vincent và Grenadines - Saint-Vincent-et-les-Grenadines
Samoa - Samoa
San Marino - Saint-Marin
São Tomé và Príncipe - São Tomé-et-Principe
Ả Rập Saudi - Arabie saoudite
Sénégal - Sénégal
Serbia - Serbie
Seychelles - Seychelles
Sierra Leone - Sierra Leone
Singapore - Singapour
Slovakia - Slovaquie
Slovenia - Slovénie
Quần đảo Solomon - Îles Salomon
Somalia - Somalie
Nam Phi - Afrique du Sud
Hàn Quốc - Corée du Sud
Nam Sudan - Soudan du Sud
Tây Ban Nha - Espagne
Sri Lanka - Sri Lanka
Sudan - Soudan
Suriname - Suriname
Swaziland - Swaziland
Thụy Điển - Suède
Thụy Sĩ - Suisse
Syria - Syrie
Tajikistan - Tadjikistan
Tanzania - Tanzanie
Thái Lan - Thaïlande
Togo - Togo
Tonga - Tonga
Trinidad và Tobago - Trinité-et-Tobago
Tunisia - Tunisie
Thổ Nhĩ Kỳ - Turquie
Turkmenistan - Turkménistan
Tuvalu - Tuvalu
Uganda - Ouganda
Ukraina - Ukraine
Ả Rập Thống nhất - Émirats arabes unis
Vương quốc Liên hiệp Anh và Bắc Ireland - Royaume-Uni
Chủng Quốc Hoa Kỳ - États-Unis
Uruguay - Uruguay
Uzbekistan - Ouzbékistan
Vanuatu - Vanuatu
Venezuela - Venezuela
Việt Nam - Viêt Nam
Yemen - Yémen
Zambia - Zambie
Zimbabwe - Zimbabwe
